TILEMAP
36 28 							-- Size of tile map in tiles
16 16 							-- Tile size & block size
images/tileset.png 	-- Tilesheet
10 10   								-- Number of tiles in tilesheet
11 12 23 24 23 24 23 24 23 24 23 24 23 24 23 24 24 23 24 23 24 24 23 24 24 23 23 24 24 23 23 24 24 23 13 11 
21 22 63 63 63 63 63 63 63 63 63 63 63 63 63 63 63 63 63 63 63 63 63 63 63 63 63 63 63 63 63 63 63 63 21 22 
43 44 0 0 0 0 0 0 0 0 0 0 0 0 0 0 0 0 0 0 0 0 0 0 0 0 0 0 0 0 0 0 0 0 41 52 
53 44 0 0 0 0 0 0 0 0 0 0 0 0 0 0 0 0 0 0 0 0 0 0 0 0 0 0 0 0 0 0 0 0 41 52 
43 44 0 0 0 0 0 0 0 0 0 0 0 0 0 0 0 0 0 0 0 0 0 0 0 0 0 0 0 0 0 0 0 0 41 52 
53 44 0 0 0 0 0 0 0 0 0 0 0 0 0 0 0 0 0 0 0 0 0 0 0 0 0 0 0 0 0 0 0 0 41 52 
43 44 0 0 0 0 0 0 0 0 0 0 2 2 2 2 2 2 2 2 2 2 2 2 0 0 0 0 0 0 0 0 0 0 41 52 
53 44 0 0 0 0 0 0 0 0 0 0 0 0 0 0 0 0 0 0 0 0 0 0 0 0 0 0 0 0 0 0 0 0 41 52 
53 44 0 0 0 0 0 0 0 0 0 0 0 0 0 0 0 0 0 0 0 0 0 0 0 0 0 0 0 0 0 0 0 0 41 52 
43 44 0 0 0 0 0 0 0 0 0 0 0 0 0 0 0 0 0 0 0 0 0 0 0 0 0 0 0 0 0 0 0 0 41 52 
53 44 2 2 2 2 2 2 2 2 2 2 2 2 0 0 0 0 0 0 0 0 2 2 2 2 2 2 2 2 2 2 2 2 41 52 
43 44 0 0 0 0 0 0 0 0 0 0 19 19 0 0 0 0 0 0 0 0 19 19 0 0 0 0 0 0 0 0 0 0 41 52 
53 44 0 0 0 0 0 0 0 0 0 0 19 19 0 0 0 0 0 0 0 0 19 19 0 0 0 0 0 0 0 0 0 0 41 52 
43 44 0 0 0 0 0 0 0 0 0 0 19 19 0 0 2 2 2 2 0 0 19 19 0 0 0 0 0 0 0 0 0 0 41 52 
43 44 2 2 2 2 2 2 2 2 2 2 19 19 0 0 19 19 19 19 0 0 19 19 2 2 2 2 2 2 2 2 2 2 41 52 
53 44 0 0 0 0 0 0 0 0 0 0 19 19 0 0 0 0 0 0 0 0 19 19 0 0 0 0 0 0 0 0 0 0 41 52 
43 44 0 0 0 0 0 0 0 0 0 0 19 19 0 0 0 0 0 0 0 0 19 19 0 0 0 0 0 0 0 0 0 0 41 52 
43 44 0 0 0 0 0 0 0 0 0 0 19 19 0 0 0 0 0 0 0 0 19 19 0 0 0 0 0 0 0 0 0 0 41 52 
53 44 2 2 2 2 2 2 2 2 2 2 19 19 0 0 0 0 0 0 0 0 19 19 2 2 2 2 2 2 2 2 2 2 41 52 
43 44 0 0 0 0 0 0 0 0 0 0 0 0 0 0 0 0 0 0 0 0 0 0 0 0 0 0 0 0 0 0 0 0 41 52 
43 44 0 0 0 0 0 0 0 0 0 0 0 0 0 0 0 0 0 0 0 0 0 0 0 0 0 0 0 0 0 0 0 0 41 52 
43 44 0 0 0 0 0 0 0 0 0 0 0 0 0 0 0 0 0 0 0 0 0 0 0 0 0 0 0 0 0 0 0 0 41 52 
53 44 0 0 0 0 0 0 2 2 2 2 2 2 0 0 0 0 0 0 0 0 2 2 2 2 2 2 0 0 0 0 0 0 41 52 
43 44 0 0 0 0 0 0 0 0 0 0 0 0 0 0 0 0 0 0 0 0 0 0 0 0 0 0 0 0 0 0 0 0 41 52 
53 44 0 0 0 0 0 0 0 0 0 0 0 0 0 0 0 0 0 0 0 0 0 0 0 0 0 0 0 0 0 0 0 0 41 52 
33 44 0 0 0 0 0 0 0 0 0 0 0 0 0 0 0 0 0 0 0 0 0 0 0 0 0 0 0 0 0 0 0 0 41 52 
53 64 2 2 2 2 2 2 2 2 2 2 2 2 0 0 0 0 0 0 0 0 2 2 2 2 2 2 2 2 2 2 2 2 61 52 
24 24 18 27 18 17 27 18 17 18 17 18 27 19 20 20 20 20 20 20 20 20 19 18 17 27 17 18 18 17 17 27 27 17 24 24