TILEMAP
36 28 							-- Size of tile map in tiles
16 16 							-- Tile size & block size
images/tileset.png 	-- Tilesheet
10 10   								-- Number of tiles in tilesheet
11 12 23 24 24 23 24 23 24 23 24 23 24 24 23 24 23 24 23 24 23 24 23 24 24 24 23 24 23 24 23 24 23 24 12 11 
21 22 63 63 63 63 63 63 63 63 63 63 63 63 63 63 63 63 63 63 63 63 63 63 63 63 63 63 63 63 63 63 63 63 21 22 
43 44 0 0 0 0 0 0 0 0 0 0 0 0 0 0 0 0 0 0 0 0 0 0 0 0 0 0 0 0 0 0 0 0 41 42 
53 44 0 0 0 0 0 0 0 0 0 0 0 0 0 0 0 0 0 0 0 0 0 0 0 0 0 0 0 0 0 0 0 0 41 52 
43 44 0 0 0 0 0 0 0 0 0 0 0 0 0 0 0 0 0 0 0 0 0 0 0 0 0 0 0 0 0 0 0 0 41 42 
53 44 0 0 0 0 0 0 0 0 0 0 0 0 0 0 0 0 0 0 0 0 0 0 0 0 0 0 0 0 0 0 0 0 41 52 
43 44 0 0 0 0 2 2 2 2 2 2 2 2 2 2 2 2 2 2 2 2 2 2 2 2 2 2 2 2 0 0 0 0 41 42 
53 44 0 0 0 0 0 0 0 0 0 0 0 0 0 0 19 19 19 19 0 0 0 0 0 0 0 0 0 0 0 0 0 0 41 52 
43 44 0 0 0 0 0 0 0 0 0 0 0 0 0 0 19 28 26 19 0 0 0 0 0 0 0 0 0 0 0 0 0 0 41 52 
43 44 0 0 0 0 0 0 0 0 0 0 0 0 0 0 19 27 18 19 0 0 0 0 0 0 0 0 0 0 0 0 0 0 41 52 
53 44 0 0 0 2 2 2 2 2 2 2 2 2 2 2 19 28 28 19 2 2 2 2 2 2 2 2 2 2 2 0 0 0 41 42 
43 44 0 0 0 0 0 0 0 0 0 0 0 0 0 0 19 25 26 19 0 0 0 0 0 0 0 0 0 0 0 0 0 0 41 52 
53 44 0 0 0 0 0 0 0 0 0 0 0 0 0 0 19 27 19 19 0 0 0 0 0 0 0 0 0 0 0 0 0 0 41 42 
43 44 0 0 0 0 0 0 0 0 0 0 0 0 0 0 19 18 29 19 0 0 0 0 0 0 0 0 0 0 0 0 0 0 41 52 
53 44 0 0 2 2 2 2 2 2 2 2 2 2 2 2 19 19 19 19 2 2 2 2 2 2 2 2 2 2 2 2 0 0 41 42 
53 44 0 0 0 0 0 0 0 0 0 0 0 0 0 0 0 0 0 0 0 0 0 0 0 0 0 0 0 0 0 0 0 0 41 52 
43 44 0 0 0 0 0 0 0 0 0 0 0 0 0 0 0 0 0 0 0 0 0 0 0 0 0 0 0 0 0 0 0 0 41 42 
53 44 0 0 0 0 0 0 0 0 0 0 0 0 0 0 0 0 0 0 0 0 0 0 0 0 0 0 0 0 0 0 0 0 41 52 
53 44 0 0 2 2 2 2 0 0 0 0 0 0 0 0 0 0 0 0 0 0 0 0 0 0 0 0 2 2 2 2 0 0 41 42 
43 44 0 0 0 0 0 0 0 0 0 0 0 0 0 0 0 0 0 0 0 0 0 0 0 0 0 0 0 0 0 0 0 0 41 52 
53 44 0 0 0 0 0 0 0 0 0 0 0 0 0 0 0 0 0 0 0 0 0 0 0 0 0 0 0 0 0 0 0 0 41 42 
43 44 0 0 0 0 0 0 0 0 0 0 0 0 0 0 0 0 0 0 0 0 0 0 0 0 0 0 0 0 0 0 0 0 41 52 
53 44 0 0 2 2 0 0 0 0 0 0 0 0 0 0 0 0 0 0 0 0 0 0 0 0 0 0 0 0 2 2 0 0 41 42 
43 44 0 0 0 0 0 0 0 0 0 0 0 0 0 0 0 0 0 0 0 0 0 0 0 0 0 0 0 0 0 0 0 0 41 52 
53 44 0 0 0 0 0 0 0 0 0 0 0 0 0 0 0 0 0 0 0 0 0 0 0 0 0 0 0 0 0 0 0 0 41 42 
43 44 0 0 0 0 0 0 0 0 0 0 0 0 0 0 0 0 0 0 0 0 0 0 0 0 0 0 0 0 0 0 0 0 41 52 
53 64 2 2 2 2 2 2 2 2 2 2 2 2 0 0 0 0 0 0 0 0 2 2 2 2 2 2 2 2 2 2 2 2 61 52 
24 24 17 27 17 27 29 17 29 27 29 17 19 19 20 20 20 20 20 20 20 20 19 17 17 29 19 27 19 27 29 19 17 27 23 24